BBBBBBBBBBBBBBBBBBBBBB
B....................B	
B....................B
B..........X.........B
B.......######.......B
B..G..............G..B
B####..G.G.G.G....###B
B.......G.G.GCG......B
B......--------......B
B...--...........--..B
B....................B
B.G.G............G.G.B
B####............####B
B....................B
B.1..................B
B####################B
BBBBBBBBBBBBBBBBBBBBBB